1
....1.X....
....11X....
....XXX....
22.......22
XX..1....XX
XX.11....XX
