1 3
1.2.1.XXX
XXXXX.XXX
2...2.XXX
X22..XXXX
XX.XXXXXX
X...1.XXX
X..1..XXX
X..1.2XXX
