1 2
1.......
....X.X.
..X.....
........
.X..X..2
.....X.3
.X.....1
....2313
