1
XX1X1XX2
22.....2
2.....22
XX.XXXXX
XX1XXXXX
