1
11.XXXXX
11.XXXXX
X..XXXXX
..22XXXX
.....XXX
...222XX
X......X
.2....2X
122222..
X.......
