1
X...11
X...22
X...XX
X2111X
X.2.2X
X....X
.....X
X....X
