1 3
XXXXXXXXX
XXXXXXXXX
X....1XXX
X22..XXXX
XX.XXXXXX
X...1.XXX
X..1..XXX
X..1.2XXX
