1
....3.....
....3.....
....2.....
.3..X..3..
.1..2..2..
.X.2X2.X..
22..2..22.
...2X2....
.22...22..
1.......1.
..........
X......XX.
X......XX.
X......XX1
X......XX.
X......XXX