1 2 
X1.XXXXXX
......2.2
.......2.
......232
...XXXXX.
...X...X.
...X11.X.
...X.1.X.
...XX1.X.
.........
.........